# Acre BR-AC
AC	BR-AC
Acre	BR-AC
Acre / Amazonas BR-AC
Acre / Mato Grosso	BR-AC
Acre State	BR-AC
Acre/Amazonas	BR-AC
Est. Acre	BR-AC
Estado do Acre	BR-AC
TERR. RIO BRANCO	BR-AC
Territorio do Rio Branco	BR-AC

# Alagoas BR-AM
Al	BR-AL
Alagoas	BR-AL
Alagoas Estado	BR-AL
Alagoas State	BR-AL
Estado Alagoas	BR-AL
State of Alagoas	BR-AL

# Amapa BR-AP
[Amap	BR-AP
[Amapa]	BR-AP
Amap	BR-AP
Amap??	BR-AP
Amapa	BR-AP
Amapa State	BR-AP
Amapa Terr.	BR-AP
Amap·	BR-AP
Amapa	BR-AP
Amapa (Terr.)	BR-AP
Amapa / Para	BR-AP
Amapa y Para	BR-AP
Amapa, Para	BR-AP
Amapa/Para	BR-AP
AmapÃ¡	BR-AP
Ampa	BR-AP
AP	BR-AP
Estado Amapa BR-AP
Terr. Amapa	BR-AP
Terr. Do Amapa	BR-AP
 
# Amazonas BR-AM
[Amazonas]	BR-AM
AM	BR-AM
AM?	BR-AM
Amaoznas	BR-AM
Amazona	BR-AM
Amazona Estado	BR-AM
Amazona Estado.	BR-AM
Amazonas	BR-AM
Amazonas (AM)	BR-AM
Amazonas - Vaupes	BR-AM
Amazonas / Bahia	BR-AM
Amazonas / Para	BR-AM
Amazonas / Roraima	BR-AM
Amazonas ?	BR-AM
Amazonas [Par	BR-AM
Amazonas Estado	BR-AM
Amazonas Manaus	BR-AM
Amazonas Province	BR-AM
Amazonas State	BR-AM
Amazonas State (BR)	BR-AM
Amazonas, munic. de Uarini	BR-AM
Amazonas, Rondônia	BR-AM
Amazonas-Imaza	BR-AM
Amazonas-Rondônia	BR-AM
Amazonas-Vaupes	BR-AM
Amazonas/Acre	BR-AM
Amazonas/Para	BR-AM
Amazonas/Rondonia	BR-AM
Amazonas/Roraima	BR-AM
Amazonas: Benjamin Constant	BR-AM
Amazonas?	BR-AM
Amazonas[?]	BR-AM
Amazone	BR-AM
Amazone River	BR-AM
Amazone-stroomgebied	BR-AM
Amazones	BR-AM
Amazonia	BR-AM
amazonie	BR-AM
Amazons	BR-AM
Amazônas	BR-AM
Amazônas / Rondônia	BR-AM
Amazônia	BR-AM
Amz BR-AM
Anaxonas BR-AM
Est Amazonas	BR-AM
Est. Amazonas	BR-AM
Est. do Amazonas	BR-AM
Estado de Amazonas	BR-AM
Estado do Amazonas	BR-AM
State of Amazonas	BR-AM
Territorio Federal Amazonas	BR-AM
Territorio Federal do Amazonas	BR-AM
 
# Bahia BR-BA
[Bahia ?]	BR-BA
BA	BR-BA
BA/ES	BR-BA
Bah	BR-BA
BahA­a	BR-BA
Bahia	BR-BA
Bahia & Piaui	BR-BA
Bahia & Rio de Janeiro	BR-BA
Bahia / Espirito Santo	BR-BA
Bahia / Minas Gerais	BR-BA
Bahia / Pernambuco	BR-BA
Bahia / Sao Paulo	BR-BA
Bahia District	BR-BA
Bahia Estado	BR-BA
Bahia State	BR-BA
Bahia, Brazil	BR-BA
Bahia, Nossa Shra. da Vitoria	BR-BA
Bahina	BR-BA
BahAa	BR-BA
Baia	BR-BA
Baiha	BR-BA
BRAZIL, Bahia	BR-BA
Est Bahia	BR-BA
Est. Do Bahia	BR-BA
Estado Bahia	BR-BA
Estado da Bahia	BR-BA
Estado de Bahia	BR-BA
Estado do bahia	BR-BA
State Of Bahia	BR-BA

# Ceará BR-CE
CE	BR-CE
Cear	BR-CE
Ceara	BR-CE
CearA¡	BR-CE
Ceara District	BR-CE
Ceara Estado	BR-CE
Ceara / Minas Gerais	BR-CE
Ceara Mirim	BR-CE
Ceara State	BR-CE
Fortaleza	BR-CE
Fortaleza Ceara	BR-CE
Estado do Ceara	BR-CE
State of Ceara	BR-CE

# Distrito Federal BR-DF
Brasilia	BR-DF
Brasilia D. F.	BR-DF
Brasilia DF	BR-DF
BRASILIA PROV.	BR-DF
Brasilia - Distrito Federal	BR-DF
Brasilia Distrito Federal	BR-DF
Brasilia, Dsto. Federal	BR-DF
BRAZIL, Distrito Federal	BR-DF
Brazilian Federal District	BR-DF
D.F.	BR-DF
DF	BR-DF
Dist. Fed. (DF)	BR-DF
Dist. Federal	BR-DF
Disto Federal	BR-DF
District Fed.	BR-DF
District Federal	BR-DF
Districto Federal	BR-DF
Distrito Federa	BR-DF
Distrito Federal	BR-DF
Distrito Federal (BR)	BR-DF
Distrito Federal / Goias	BR-DF
Distrito Federal/Goi?s	BR-DF
Distrito Federal/Goias	BR-DF
Distrito Federal	BR-DF
Dsto. Federal	BR-DF
Federal Dist	BR-DF
Federal District	BR-DF
Federal District, Brasilia	BR-DF
 
# Espírito Santo BR-ES
Epirito Santo	BR-ES
ES	BR-ES
Esirito Santo	BR-ES
Esp. Santo	BR-ES
Esperito Santo	BR-ES
Espirito Paulo	BR-ES
Espirito Santao	BR-ES
Espirito Santo - Minas Gerais	BR-ES
Espirito Santo ?	BR-ES
Espirito Santo Estado	BR-ES
Espirito Santo State	BR-ES
Espirito Santos	BR-ES
Espirito, off Guarapari	BR-ES
Espiritu Santo	BR-ES
Espiritu Santo Id.	BR-ES
Espiritu Santos	BR-ES
Espiru De Santo	BR-ES
Espirito Santo	BR-ES
EspÃArito Santo	BR-ES
Espirito Santo	BR-ES
Espiritu Santo	BR-ES
Esp�rito Santo	BR-ES
Estado do Espirito Santo	BR-ES
Spirito Santo	BR-ES
State of Espirito Santo	BR-ES

# Goias BR-GO
[Goi	BR-GO
Est. do Goias	BR-GO
Estado De Goias	BR-GO
Estado de Goia¡s	BR-GO
Gaias	BR-GO
Ggoias	BR-GO
GO	BR-GO
Goais	BR-GO
Goayz	BR-GO
Goi	BR-GO
Goi s	BR-GO
Goi-s	BR-GO
Goiania	BR-GO
Goias	BR-GO
Goias / Minas Gerais	BR-GO
Goias [Tocantins]	BR-GO
Goias State	BR-GO
GOIAS, SANTA ISABEL	BR-GO
Goias/Maranhao/Para	BR-GO
Goiaz	BR-GO
Goi·s	BR-GO
Goias	BR-GO
Goias (GO)	BR-GO
Goias / Mato Grosso / Para / Rondônia	BR-GO
Goias / Minas Gerais	BR-GO
Goias / Minas Gerais / Para	BR-GO
Goias ?	BR-GO
Goias [Tocantins]	BR-GO
Goias/Para	BR-GO
Goias/Tocantins	BR-GO
GoiA¡s	BR-GO
Goi�s	BR-GO
State of Goias	BR-GO
 
# Maranhao BR-MA
Est. do Maranhao	BR-MA
Maranh	BR-MA
Maranh-o	BR-MA
Maranhao	BR-MA
Maranhao (Para-Maranhao)	BR-MA
Maranhao and Para	BR-MA
Maranhao State	BR-MA
Maranhao/Piaui	BR-MA
Maranha\u0080¹o	BR-MA
Maranhao, Sao Paulo	BR-MA
MaranhA£o	BR-MA
Maranh„o	BR-MA
State of Maranaho	BR-MA
State of Maranhao	BR-MA
 
# Mato Grosso BR-MT
BRAZIL, Mato Grosso State	BR-MT
Est Mato Grosso	BR-MT
Est. do Mato Grosso	BR-MT
Est. Mato Grosso	BR-MT
Estado de Mato Grosso	BR-MT
M.T.	BR-MT
Maro Grosso	BR-MT
Mata Grosso	BR-MT
Mato Crasso	BR-MT
Mato Gorsso	BR-MT
Mato Grasso	BR-MT
Mato Grosse	BR-MT
Mato Grosso	BR-MT
Mato Grosso / Minas Gerais	BR-MT
Mato Grosso / Para	BR-MT
Mato Grosso / Rondônia	BR-MT
Mato Grosso ?	BR-MT
Mato Grosso do Norte	BR-MT
Mato Grosso State	BR-MT
Mato Grosso.	BR-MT
Mato Grosso/Minas Gerais	BR-MT
Matogrosso	BR-MT
Matto Grasso	BR-MT
Matto Groso	BR-MT
Matto Grosso	BR-MT
Matto Grosso State	BR-MT
Mt	BR-MT
Estado de Mato Grosso	BR-MT
Est. do Mato Grosso	BR-MT
Est Mato Grosso	BR-MT
MT	BR-MT
Mtg	BR-MT
Rato Grosso	BR-MT
State of Mato Grosso	BR-MT
 
# Matro Grosso do Sul BR-MS
Mato Graso do Sul	BR-MS
Mato Grosso [do Sul]	BR-MS
Mato Grosso del Sur	BR-MS
Mato Grosso do Sul	BR-MS
Mato Grosso do Sul / Sao Paulo	BR-MS
Mato Grosso do Sul ?	BR-MS
Mato Grosso do Sul State	BR-MS
Mato Grosso do Sul.	BR-MS
Mato Grosso so Sul State	BR-MS
mato grosso sud	BR-MS
Mato Grosso Sul State	BR-MS
Matos Grosso do Sul	BR-MS
Matto Grasso do Sul	BR-MS
Matto Grosso do Sul	BR-MS
MS	BR-MS
Mts	BR-MS
State of Mato Gros So Do SuI	BR-MS
State of Mato Grosso Do SuI	BR-MS
State of Mato Grosso do Sul	BR-MS
 
# Minas Gerais BR-MG
E Minas Gerais	BR-MG
Est. do Minas Gerais	BR-MG
Estado de Minas Gerais	BR-MG
MG	BR-MG
M. Geraes	BR-MG
Menas Gerais	BR-MG
MG	BR-MG
MG/ES	BR-MG
Mina Geraes	BR-MG
Mina Gerais	BR-MG
Minais Gerais	BR-MG
Minas	BR-MG
Minas Geraes	BR-MG
Minas Geraeus	BR-MG
Minas Gerais	BR-MG
Minas Gerais (MG)	BR-MG
Minas Gerais / Rio de Janeiro	BR-MG
Minas Gerais / Sao Paulo	BR-MG
Minas Gerais ?	BR-MG
Minas Gerais Estado	BR-MG
Minas Gerais State	BR-MG
Minas Gerais-Bahia	BR-MG
Minas Gerais; Rio de Janeiro	BR-MG
Minas Gerias	BR-MG
Minas Geraes	BR-MG
Minas Minas Gerais	BR-MG
Mines Gerais	BR-MG
State of Minas Gerais	BR-MG
 
# Pará BR-PA
[ParA¡]	BR-PA
Est ParA¡	BR-PA
Est. do Para	BR-PA
Estado de Para	BR-PA
Estado do Para	BR-PA
Estados Para	BR-PA
PA	BR-PA
Par-	BR-PA
Par??	BR-PA
Par?? State	BR-PA
Para	BR-PA
Para District	BR-PA
Para Estado	BR-PA
Para State	BR-PA
Para States	BR-PA
Para/Tocantins?	BR-PA
Par·	BR-PA
Para	BR-PA
Para (PA)	BR-PA
Para bx/ Amazonas	BR-PA
Para Estado	BR-PA
Para-Acre	BR-PA
Para/Amapa	BR-PA
Para/Piaui	BR-PA
ParÃ¡	BR-PA
ParA¡, SA£o Felix do Xingu	BR-PA
ParA¡/Maranhao	BR-PA
Par�	BR-PA
State of Par??	BR-PA
State of Para	BR-PA
 
# Paraiba BR-PB
Est. do Paraiba	BR-PB
Parahyba	BR-PB
Parahyba (= Paraiba)	BR-PB
Parahyba Do Norte	BR-PB
Paraiba	BR-PB
Paraiba ?	BR-PB
Paraiba do Norte	BR-PB
Paraiba State	BR-PB
Paralba	BR-PB
Paraiba	BR-PB
PB	BR-PB

# Parana BR-PR
E Parana	BR-PR
Est. do Parana	BR-PR
Estado de Parana	BR-PR
Estado do Parana	BR-PR
Paran	BR-PR
Paran? [?]	BR-PR
Parana	BR-PR
Parana Coast	BR-PR
Parana Estado	BR-PR
Parana Province	BR-PR
Parana State	BR-PR
Parand	BR-PR
Paran·	BR-PR
Paranß	BR-PR
Parana	BR-PR
Parana (23.16S-50.04W)	BR-PR
Parana (23°16'S-50°04W)	BR-PR
Parana / Sao Paulo	BR-PR
Parana State	BR-PR
ParanA¡	BR-PR
Paran�	BR-PR
E Parana	BR-PR
Estado do Parana	BR-PR
Estado de Parana	BR-PR
PR	BR-PR
PR?	BR-PR
PROV. PARANA	BR-PR
State of Parana	BR-PR
 
# Pernambuco BR-PE
Est. do Pernambuco	BR-PE
Estado de Pernambuco	BR-PE
Estado Pernambuco	BR-PE
PE	BR-PE
Penambuco	BR-PE
Per	BR-PE
Permanbuco	BR-PE
Pernambuca	BR-PE
Pernambuca Estado	BR-PE
Pernambuco	BR-PE
Pernambuco Estado	BR-PE
Pernambuco State	BR-PE
Pernanbuco	BR-PE
Pernanbuco State	BR-PE
Pernembuco Estado	BR-PE
Recife	BR-PE
State of Pernambuco	BR-PE

# Piaui BR-PI
Est. do Piaui	BR-PI
Estado do Piaui	BR-PI
PI	BR-PI
Piau	BR-PI
Piauby	BR-PI
Piauhy	BR-PI
Piauhi	BR-PI
Piaui	BR-PI
Piaui State	BR-PI
PiauA	BR-PI­
Piaui	BR-PI
Piaui (Piauhy)	BR-PI
Piaui / Santa Catarina	BR-PI
Piaui-Goias	BR-PI
State of Piaui	BR-PI

# Rio de Janeiro BR-RJ
[Rio de Janeiro-Sao Paulo-Minas Gerais border area]	BR-RJ
Est. do Rio	BR-RJ
Est. do Rio de Janeiro	BR-RJ
Estado de Rio de Janeiro	BR-RJ
Estado de R�o de Janeiro	BR-RJ
Estado do Rio	BR-RJ
Estado do Rio de Janeiro	BR-RJ
Estado do Rio de Janiero	BR-RJ
Estado Rio de Janeiro	BR-RJ
Estado Rio de Janiero	BR-RJ
R.J.	BR-RJ
Rio [de Janeiro]	BR-RJ
Rio de Janeira	BR-RJ
Rio de Janeiro	BR-RJ
Rio de Janeiro (RJ)	BR-RJ
Rio de Janeiro / Sao Paulo	BR-RJ
Rio de Janeiro :	BR-RJ
Rio De Janeiro Estado	BR-RJ
Rio de Janeiro province	BR-RJ
Rio De Janeiro State	BR-RJ
Rio de Janeiro State, Guanabara Bay	BR-RJ
Rio de Janeiro-Belem	BR-RJ
Rio de Janeiro-Sao Paulo	BR-RJ
Rio de Janerio	BR-RJ
Rio de janero state	BR-RJ
Rio de Janiero	BR-RJ
Rio De Janiero Estado	BR-RJ
Rio de Janiero State	BR-RJ
Rio Estado	BR-RJ
Rio Janeir. Prov.	BR-RJ
Rio Janeiro	BR-RJ
Rio ou RJ	BR-RJ
RJ	BR-RJ
RJ ou SP?	BR-RJ
RJ/MG	BR-RJ
RJ/SP	BR-RJ
RJ?	BR-RJ
RJ? ou SP?	BR-RJ
RÃ­o de Janeiro	BR-RJ
Rio de Janeiro/Minas Gerais	BR-RJ
State of Rio de Janeiro	BR-RJ
State Rio de Janeiro	BR-RJ

# Rio Grande do Sul BR-RS
[Rio Grande do Sul]	BR-RS
Est. do Rio Grande do Sul	BR-RS
Estado de Rio Grande do Sul	BR-RS
Estado do Rio Grande do Sul	BR-RS
Estado Rio Grande Do Sul	BR-RS
Porto Alegre	BR-RS
Porto Allegre	BR-RS
Prov. Rio Grande Do Sul	BR-RS
R s	BR-RS
r.grande do sul	BR-RS
Rgs	BR-RS
Rio de Grande do Sul	BR-RS
Rio G. do Sul	BR-RS
Rio Gande do Sul	BR-RS
Rio Grabde do Sol	BR-RS
Rio Grand do Sul	BR-RS
Rio Grande de Sol	BR-RS
Rio Grande de Sul	BR-RS
Rio Grande de Sur Province	BR-RS
Rio Grande del Sol	BR-RS
Rio Grande del Sur	BR-RS
Rio Grande di Sul	BR-RS
Rio Grande do S	BR-RS
Rio Grande Do Sol	BR-RS
Rio Grande do Sol State	BR-RS
Rio Grande do Soul	BR-RS
Rio Grande do sud	BR-RS
Rio Grande do Sul	BR-RS
Rio Grande do Sul (RS)	BR-RS
Rio Grande do Sul / Santa Catarina	BR-RS
Rio Grande Do Sul / Sao Paulo	BR-RS
Rio Grande do Sul ?	BR-RS
Rio Grande do Sul State	BR-RS
Rio Grande do Sur	BR-RS
rio grande du sud	BR-RS
Rio Grande Sol	BR-RS
Rio Grande Sul	BR-RS
Rio Grando do Sul	BR-RS
RioGrande do Sul	BR-RS
R s	BR-RS
RS	BR-RS
Rio Grande del Sur	BR-RS
Rio Grande do Sul	BR-RS
Rio Grande do Sur	BR-RS

# Rio Grande do Norte BR-RN
Estado Rio Grande do Norte	BR-RN
R. Norte Do Grande	BR-RN
R.Grande N. State	BR-RN
R.Grande Norte State	BR-RN
Rgn	BR-RN
Rio Grande de Norte	BR-RN
Rio Grande del Norte	BR-RN
Rio Grande do Horte	BR-RN
Rio Grande do nNrte	BR-RN
Rio Grande do Norte	BR-RN
Rio Grande do Norte (State)	BR-RN
Rio Grande do Norte District	BR-RN
Rio Grande do Norte State	BR-RN
Rio Grande Nord	BR-RN
Rio Grande Norte	BR-RN
RN	BR-RN

# Sao Paulo BR-SP 
[Sao Paulo]	BR-SP
BRAZIL, Sao Paulo State	BR-SP
E Sao Paulo	BR-SP
Est. do Sao Paulo	BR-SP
Estado de Sao Paulo	BR-SP
Estado Sao Paulo	BR-SP
PROV. SAO PAULO	BR-SP
Prov. St. Paul	BR-SP
S. Paulo	BR-SP
Sao - Paulo	BR-SP
Sao Paolo	BR-SP
Sao Paolo State	BR-SP
Sao Pauco	BR-SP
Sao Paulo	BR-SP
Sao Paulo Estado.	BR-SP
Sao Paulo Province	BR-SP
Sao Paulo State	BR-SP
Sao Paulo, Litoral Sul	BR-SP
Sau Paolo	BR-SP
Sau Paulo	BR-SP
Sao Paulo	BR-SP
SP	BR-SP
State of Sao Paulo	BR-SP
SA\u008Bo Paulo	BR-SP
Sao Paulo	BR-SP
Sao Paolo	BR-SP
Sao Paraulo	BR-SP
Sao Paulo	BR-SP
Sao Paulo Estado	BR-SP
Sao PauloState	BR-SP
SuO Paulo	BR-SP
SÿO Paulo	BR-SP
S„o Paulo	BR-SP
S�o Paulo state	BR-SP

# Santa Catarina BR-SC
Est. do Santa Catarina	BR-SC
Est. Santa Catharina	BR-SC
S�o Paulo state	BR-SP 
SP	BR-SP 
S. Paulo	BR-SP  
State of Sao Paulo	BR-SP  
SuO Paulo	BR-SP 
SÿO Paulo	BR-SP 

# Santa Catarina BR-SC
SC	BR-SC
S. Cararina	BR-SC
S. Catarina	BR-SC
S.Cat.State	BR-SC
S.C.Brazil	BR-SC
Estado de Santa Catarina	BR-SC
Estado de Sta. Catarina	BR-SC
Estado Santa Catarina	BR-SC
S. Cararina	BR-SC
S. Catarina	BR-SC
S.C.Brazil	BR-SC
S.Cat.State	BR-SC
Santa Cantarina	BR-SC
Santa Catairna	BR-SC
Santa Catalina	BR-SC
Santa Catarina	BR-SC
Santa Catarina (Catharina)	BR-SC
Santa Catarina Prov.	BR-SC
Santa Catarina Province	BR-SC
Santa Catarina State	BR-SC
Santa Caterida	BR-SC
Santa Caterina	BR-SC
Santa Caterina, District Jaragua	BR-SC
Santa Catharina	BR-SC
Santa Catherina	BR-SC
SC	BR-SC
St Catarina	BR-SC
St Catherinae	BR-SC
St. Catharina	BR-SC
Sta Catarina	BR-SC
Sta. Cat.	BR-SC
Sta. Catharina	BR-SC

# Rondônia BR-RO
Est. do Rondonia	BR-RO
R o	BR-RO
RO 	BR-RO
Rond	BR-RO
Rond-nia	BR-RO
Rondonia	BR-RO
Rondonia (Terr.)	BR-RO
Rondonia Province	BR-RO
Rondonia State	BR-RO
Rondonia terr.	BR-RO
Rondoniai	BR-RO
RondA´nia	BR-RO
Rondonia	BR-RO
RondUnia	BR-RO
Rondonia/Mato Grosso	BR-RO
State of Rondonia	BR-RO
Territorio de Guapore [now Estado de Rondonia]	BR-RO

# Sergipe BR-SE
SE	BR-SE
SE Brazil 	BR-SE
Ser	BR-SE
Sergipe	BR-SE

# Roraima BR-RR
Rora	BR-RR
Roraia	BR-RR
roraima	BR-RR
Roraima	BR-RR
Roraima (Terr.)	BR-RR
Roraima;Amazonas	BR-RR
RR	BR-RR
Terr. Roraima	BR-RR
Terr. Roraima (RR)	BR-RR

# Tocantins BR-TO
Est. do Tocantins	BR-TO
Estado do Tocantins	BR-TO
State of Tocantins	BR-TO
TO	BR-TO
Tocantins	BR-TO
Tocantins/Goias	BR-TO
Tocatins	BR-TO
Toncantins	BR-TOq